# # # # # # #
# < . . . . #
# . # # # . #
# . # # # . #
# . # # # . #
# . . . . v #
# # # # # # #

3
# # # # # # #
# . . . . . #
# . # # # . #
# . # # # . #
# . # # # . #
# . . . . ^ #
# # # # # # #