1
# # # # # # #
# . . . . . #
# . # # # . #
# . # # # . #
# . # # # . #
# < . . . . #
# # # # # # #
