0
# # # # # # #
# . . . . . #
# . # # # . #
# . # # # . #
# . # # # . #
# . . . . > #
# # # # # # #
