5
# # # # # # #
# . . . . . #
# . . . . . #
# . . . . . #
# . . . . . #
# < . . . . #
# # # # # # #
