3
# # # # # # #
# . . . . . #
# . # # # . #
# . # # # . #
# . # . # . #
# > . . # . #
# # # # # # #
