# # # # # # #
# . . . . . #
# . # # # . #
# . # # # . #
# ^ # # # . #
# . . . . . #
# # # # # # #
